111111
101001
100011
101001
111111